##################################################
#......######..###....##.###..............#......#
#.######....##.....##.##.....####.#######.#.####.#
#.....##.##.####.####.##.#.#.#..#.#...###.#.##...#
#.###.##.#..#....##...##.###.##...#.#...#.....##.#
#.###....#.##.###.###.###....######.###.########.#
#...######.##.....#.#.....####...##.#.#..........#
###.##...#....###.#..#.####....#....#.############
#.#....#.########.##.#..#.#.#########.##......##.#
#...###.#.##......#...###.........#......####..#.#
###.....#.##.######.#.##.#.#.####.##.####.####...#
###.#####........#.......###.#..#.............##.#
#....##...######.#####.###...##.#######.#####.##.#
#.##.###.#..#....#...#..##.###....##.##.#...#...##
####.##..##.#.####.#.##.##.##..##.......#.#.###.##
#o....#.###.##...##........#..##.########.#..##..#
#####.##.......#....########.#........###.##.#.#.#
#...#.#..#####.#########.....###.####.....#..#...#
#.#....####.####.....######.#....####.####.#####.#
#.####...........###.######.#.#####...#..........#
#.#...#####.########.......##.##....###.#######.##
#.###.#...#.#.....########....##.####.###...###.##
#.....#.#...#.###.#####..#####..##........#.....##
#######.#####.###.......##...##.##.####.#######.##
#.......#...#..#######.##..#.....#.##...#..###..##
#.#######.####.#....##.##.######...##.####....####
#.........##...#.##....#..##...#####......###.#..#
#########....###.#.###.#.###.###.....####.....##.#
#.......###.##...#.###.#.....#########...####.##.#
#.######....##.##....#.######...###....#.......#.#
#.#.....#####..##.##.###......#.###.#######.##...#
#.#.#.#...#...##..##.###.######.....#.......##.###
#.###.##########.##......##...########.#######.###
#.....#.......##.#########..#......###.#.......###
#######.########..#.#......###.####....####.##.###
#.......#.##...##.#.###.##.###....#.#######.#..###
#.#######.##.#.##.#.....##.#####.##..##..##.######
#.........##.#.##.########.#.......#.###........##
#########.##.#.##....#.....#.###.###.#...##.###.##
#....####.##.#.#.#.#########.###.###.#.####.##..##
####......#..#.#...###.......##......#......##.###
#....####.####.#######.#######################.###
#.#######......#.......#.....###...............###
#........######..#####.#.####....####.###.##.##..#
####.#.#....#.###....#.#.####.#######.######.##.##
#....########...#.###.##.....#........#....#.##.##
#.##.#.....#..#.#...#.######...###.####.##.#.*#.##
#...##.###.####.###.......########.####.##.####.##
#.#....###..........###.#......###......##......##
##################################################