##################################################
#......######..###////##.###//////////////#//////#
#.######////##..///##/##..../####.#######/#/####/#
#/////##/##/####/####/##.#.#/#..#.#///###/#/##../#
#/###/##/#//#////##../##.###/##...#/#///#///..##/#
#/###////#/##/###.###/###////######/###/########/#
#///######/##/....#.#/////####///##/#.#//////////#
###/##...#////###.#..#.####////#////#.############
#.#/...#.########.##.#..#.#/#########.##......##.#
#../###.#.##......#...###..///////#......####..#.#
###/....#.##.######.#.##.#.#.####/##.####.####...#
###/#####........#.......###.#..#/////////////##.#
#..//##...######.#####.###...##.#######.#####/##.#
#.##/###.#..#....#...#..##.###....##.##.#...#///##
####/##..##.#.####.#.##.##.##..##.......#.#.###/##
#o///.#.###.##...##........#..##.########.#..##//#
#####.##.......#....########.#........###.##.#.#/#
#...#.#..#####.#########.....###.####.....#..#../#
#.#....####.####.....######.#....####.####.#####/#
#.####...........###.######.#.#####...#........//#
#.#...#####.########.......##.##....###.#######/##
#.###.#...#.#.....########....##.####.###///###/##
#.....#.#...#.###.#####..#####..##.....///#/////##
#######.#####.###.......##...##.##.####/#######.##
#.......#...#..#######.##..#.....#.##///#..###..##
#.#######.####.#....##.##.######...##/####....####
#.........##...#.##....#..##...#####./////###.#..#
#########....###.#.###.#.###.###.....####/////##.#
#.......###.##...#.###.#.....#########...####/##.#
#.######....##.##....#.######...###....#.....//#.#
#.#.....#####..##.##.###......#.###.#######.##/..#
#.#.#.#...#...##..##.###.######.....#.......##/###
#.###.##########.##......##...########.#######/###
#.....#.......##.#########..#......###.#...////###
#######.########..#.#......###.####....####/##.###
#.......#.##...##.#.###.##.###....#.#######/#..###
#.#######.##.#.##.#.....##.#####.##..##..##/######
#.........##.#.##.########.#.......#.###.../////##
#########.##.#.##....#.....#.###.###.#...##.###/##
#....####.##.#.#.#.#########.###.###.#.####.##//##
####......#..#.#...###.......##......#......##/###
#....####.####.#######.#######################/###
#.#######......#.......#.....###............///###
#........######..#####.#.####....####.###.##/##..#
####.#.#....#.###....#.#.####.#######.######/##.##
#....########...#.###.##.....#........#....#/##.##
#.##.#.....#..#.#...#.######...###.####.##.#/*#.##
#...##.###.####.###.......########.####.##.####.##
#.#....###..........###.#......###......##......##
##################################################